6 10
|--------|
|FFF|....|
|........|
|FF..P@|.|
|..F...|.|
|--------|